NO textures/north.png

SO  ./textures/south.png

            C    0 ,  125,            255

EA  textures/east.png
WE  textures/pig128.png
                 
 F       255 , 50,0

1111111111111111111111111
100001000001000000111111111
1111110001100000000000001
101000000000000N000000001
1111111110110000000000001
10000000001111000000000011
11110111111111110111000001
11111111111111111111111111