11111111111111111111111111111
10000000000100000000100010001
10010000100000000100000010001
10000000000100100100010010001
10000000000000000000000000001
10000010000101000010000000001
10000000000000E00000100100001
10100000010001000100000000001
10000010010000000000000000001
10000000000000000100000100001
10000100010000100000000000001
10000000000000010000100000001
10100010000010000100000100001
10000000010000000000010000001
11111111111111111111111111111