111111111111111111111111111
100000000000000000000010001
100111000000000000000011111
100000001100000000000000001
1000000000100E0000010010001
100000000000000000010000001
100010000000000000100000001
100010000111000000100000001
100010000000000000000000001
111111111111111111111111111