NO textures/ggiboury.png

SO  ./textures/ggiboury.png

            C    0 ,  125,            255

EA  textures/ggiboury.png
WE  textures/ggiboury.png
                 
 F       255 , 50,0

1111111111111111111111111
100001000001000000111111111
1111110001100000000000001
1010000000000000000000001
1111111110110000000000001
100000000011110000S0000011
11110111111111110111000001
11111111111111111111111111