NO textures/north.png

SO  ./textures/south.png

            C    0 ,  125,            255

EA  textures/east.png
WE  textures/pig128.png
                 
 F       255 , 50,0

1111111111111111111111111
100001000001000000111111111
1111110001100000000000001
101000000000000N0000000011111111111111111111111111111
111111111011000000000000100000000000000000000000000111
1000000000111100000000001000000000000000000000000011111111
1111011111111111011100000111111111111111111111111111111
1111111111111111111111111